# Mapa 18x18
# Formato: LARGURA ALTURA
# Grid de IDs de tile
# 0=PAREDE 1=CHAO 2=AGUA 3=AREIA 4=GRAMA 5=LAVA 6=GELO 7=PILAR 8=SAIDA 9=PISADO
18 18

0 0 0 0 0 0 0 0 0 0 0 0 0 0 0 0 0 0
0 1 1 1 1 2 2 1 1 1 1 1 6 6 6 1 1 0
0 1 7 1 1 2 2 1 4 4 4 1 6 7 6 1 1 0
0 1 1 3 3 1 1 4 4 4 4 1 6 6 6 3 1 0
0 1 1 3 7 1 1 4 7 4 4 1 1 1 3 3 1 0
0 1 5 5 1 1 1 4 4 4 1 1 1 3 3 7 1 0
0 1 5 5 5 1 1 1 1 1 1 1 1 1 3 3 1 0
0 1 5 7 5 1 0 0 1 1 1 0 0 1 1 1 1 0
0 1 1 1 1 1 0 0 1 2 1 0 0 1 6 6 1 0
0 0 1 1 1 0 0 1 1 2 1 1 0 1 6 7 1 0
0 0 0 1 1 0 1 1 1 1 1 1 1 1 6 6 1 0
0 1 1 1 1 1 1 7 1 1 1 7 1 1 1 1 1 0
0 1 3 3 1 5 5 1 1 1 1 1 5 5 1 4 4 0
0 1 3 1 1 5 1 1 1 1 1 1 1 5 1 4 1 0
0 1 1 1 1 1 1 1 2 1 2 1 1 1 1 1 1 0
0 1 6 6 1 1 1 1 2 8 2 1 1 1 6 6 1 0
0 1 6 1 1 1 1 1 2 2 2 1 1 1 1 6 1 0
0 0 0 0 0 0 0 0 0 0 0 0 0 0 0 0 0 0

WALKABLE
0 0
1 1
2 0
3 1
4 1
5 1
6 1
7 0
8 1
9 1

ITEMS
C 3 2
C 8 2
C 13 2
C 3 12
C 13 12
C 9 15
C 2 5
C 14 5
C 5 13
C 11 13
